rollno,name,c,cpp,java,total,percentage,grade
1,Ayesha,75,86,89,250,83.33,A
2,Saadiya,78,87,88,253,84.33,A
3,Tarannum,84,85,89,258,86,A
4,Uzma,75,84,78,237,79,B
5,Saniya,55,41,44,140,46.67,D
6,Alfiya,75,76,77,228,76,B
7,Tanzeela,48,82,81,211,70.33,B
8,Simran,79,71,72,222,74,B
9,Shaheen,61,57,88,206,68.67,C
10,Munizah,91,92,93,276,92,A
